1111111111111
10C10P00000C1
1000011111001
100011E000C01
1111111111111